BOOK	B UH K
BOX	B AA K S
CALENDAR	K AE L AH N D ER
FINISH	F IH N IH SH
IS	IH Z
LEFT	L EH F T
OF	AH V
ON	AA N
ON(2)	AO N
RIGHT	R AY T
ROBOT	R OW B AA T
ROBOT(2)	R OW B AH T
SIDE	S AY D
START	S T AA R T
STOP	S T AA P
THE	DH AH
THE(2)	DH IY
UNDER	AH N D ER
UPSIDE	AH P S AY D
WHAT	W AH T
WHAT(2)	HH W AH T
